2 5 1583 975 4128 2023 3551 
2 7 4258 2979 4253 1119 4224 1237 4195 
1 5 4199 4213 4225 4229 1119 
1 3 4125 2750 4160 
2 5 2802 753 4297 2045 4260 
1 5 394 4293 4279 4273 4260 
1 7 738 4367 3038 4366 1543 1592 4346 
1 2 738 1592 
1 4 4336 4334 4322 4328 
1 3 4231 3040 4237 
2 8 3309 4026 1580 4033 1163 4039 1992 4035 
1 4 4059 4079 263 3143 
2 7 1189 3848 3840 2453 3842 2640 3856 
1 4 2534 3829 3365 3842 
1 3 3840 2351 44 
1 6 3842 3843 3845 3850 3484 3856 
1 7 2482 1272 3834 2764 3824 3359 3810 
1 4 3831 2561 729 2764 
1 4 3886 3880 3870 3861 
1 3 3866 3470 3880 
1 7 3930 2422 568 2774 3906 2558 3886 
1 5 2558 3692 37 3895 1715 
1 4 3404 3241 832 2774 
3 5 3931 3934 3956 3963 3659 
2 2 3931 2774 
1 5 3659 2755 3940 3951 3437 
1 3 3404 1685 3940 
3 6 3985 1071 3960 3955 1063 3954 
1 4 3960 3949 3538 3930 
3 5 3960 3952 3942 2401 3931 
1 3 1071 3979 1675 
2 6 4034 2005 4024 4013 4009 310 
1 5 4017 2833 2839 2231 4024 
1 2 2839 1270 
2 4 310 1841 1290 3996 
1 4 3996 1668 804 1883 
2 7 1841 4018 4030 1785 4077 4083 4104 
3 4 4030 2193 492 4034 
1 4 4104 2302 4141 4151 
1 6 4104 4116 1609 4159 4167 3112 
1 2 4151 718 
2 2 3112 1673 
1 4 2939 323 2185 1710 
1 2 323 4178 
2 11 4104 2946 155 2631 4105 3010 2795 2728 4056 838 2833 
1 5 155 4063 4055 2220 4034 
1 2 4017 1983 
2 6 3512 4150 3478 4169 1474 2313 
1 2 2602 1474 
1 5 2337 1419 2933 3860 3398 
2 5 3398 3543 1257 1982 3903 
3 5 3903 1221 3291 3434 1858 
2 4 3903 3451 3896 540 
1 3 3896 3426 3116 
1 6 1858 3939 3947 1360 3685 1632 
1 3 3903 3413 1140 
1 3 3434 517 540 
3 4 1734 4073 3166 2686 
2 3 2686 4036 3069 
1 6 2686 4053 3546 2930 4011 2160 
1 6 2160 3983 2718 3988 1813 3966 
1 2 2477 1673 
1 4 3966 3970 3958 1085 
2 5 2181 1251 2959 3349 4001 
1 7 1734 1818 4071 1862 3400 4037 3069 
1 5 3069 3242 3379 1935 3988 
2 5 2681 1309 2951 1180 4091 
1 2 3690 1180 
1 10 4127 4145 4153 1117 443 3093 973 1350 2644 4090 
1 3 3491 3497 443 
2 5 4127 2006 3407 2277 3491 
1 4 3491 2080 4107 4090 
3 7 3644 3324 4254 4238 4220 4202 3457 
2 9 3324 4255 4256 4250 1730 745 4259 4247 3392 
1 3 3392 4245 991 
2 5 3457 3436 2084 4242 4250 
1 7 2084 4221 4214 4226 4239 1122 4247 
1 2 1645 1862 
1 3 3425 2467 4203 
1 8 3425 4227 851 451 4198 1761 3122 3050 
2 6 2286 4385 2414 62 4356 1004 
1 2 16 1825 
2 4 16 2794 102 198 
1 3 102 4310 1384 
2 3 16 4278 4286 
1 3 2286 2890 2683 
2 4 1436 1567 3454 4415 
1 9 1436 495 4451 2076 4430 3665 4402 2945 1976 
1 3 1976 2815 1215 
2 5 4437 2349 2460 2650 3454 
1 4 3454 31 4411 837 
3 8 3030 4806 4813 4820 4826 3145 4873 2829 
2 7 3030 4814 380 4851 2300 1352 2829 
1 6 3030 1714 3114 2502 1923 2212 
1 4 4799 4790 520 1725 
1 4 644 4712 813 2375 
1 4 2375 2746 1823 4692 
1 2 4692 2746 
3 4 4692 270 4684 2194 
2 8 2194 3361 2808 2338 4716 1952 4737 1725 
1 8 2212 1169 1235 1043 4756 680 454 644 
1 7 2300 15 4869 180 1151 1586 1169 
2 8 3184 4984 4970 2532 2674 2989 2083 2829 
1 7 2989 854 2901 3614 477 1197 2487 
1 5 4984 594 1241 1013 3614 
3 6 1043 1781 388 793 106 3211 
2 10 3211 1996 2260 107 356 3165 2472 3260 4895 1342 
1 14 2487 2697 2573 3130 2903 1336 514 4930 1967 1477 4910 2702 4908 1342 
1 10 356 192 4800 4794 2145 1584 1998 4821 4841 4852 
3 3 4799 3149 3030 
2 6 2502 505 2473 467 763 2194 
1 3 107 2902 3263 
2 3 2102 1997 857 
1 5 2102 2032 3074 1847 135 
1 6 135 3059 2146 2749 3458 4651 
1 5 2749 1126 1829 4593 268 
1 6 1952 1954 2407 957 3078 135 
1 11 4651 2115 2582 2866 259 2886 2539 3148 765 4681 2746 
1 5 2102 2156 3584 1472 2603 
1 7 2603 2966 2818 1131 1792 3462 1436 
1 5 3563 1279 2382 4541 2966 
1 6 1792 2613 4483 1160 4492 3563 
1 6 3563 4493 1386 73 3495 268 
2 3 4596 698 268 
1 6 4596 4579 479 4605 281 2603 
1 6 1472 4592 2082 205 4553 4540 
1 7 4540 2109 2986 954 4470 1903 1436 
2 3 4415 4405 2286 
1 6 198 1971 3294 262 638 2286 
1 4 4651 3277 21 1569 
1 3 4493 1555 4468 
1 3 2194 2785 2866 
3 4 2240 4892 4882 4864 
2 11 3600 4805 160 312 4816 1129 17 2021 1029 4835 4827 
1 6 2369 4746 2994 2063 2955 3381 
1 17 4827 4810 1496 393 3341 4744 606 3636 316 4732 1144 2227 1749 748 1447 2236 1031 
1 7 4522 2272 4528 4517 2830 2566 3605 
2 15 1031 1147 4669 2409 4659 1007 2046 2533 1024 599 2609 1175 4547 4535 4522 
1 3 2533 685 1778 
1 10 735 4460 4474 1150 4513 1435 4543 4551 38 615 
1 3 3600 2568 4743 
2 9 4732 864 1926 4697 979 149 405 3140 757 
3 7 4496 11 4475 3033 2157 325 735 
2 10 757 100 2029 1311 2367 4565 532 1375 2011 4496 
1 10 100 473 4662 4657 2522 4643 1696 3096 2497 1674 
1 10 4743 1412 2961 2747 4702 3502 518 1788 2654 1696 
2 11 1031 3628 2090 1016 4674 3055 2570 2114 1327 1307 100 
1 7 4674 1205 4646 4630 1765 2336 4551 
1 15 615 2938 908 2827 3319 4578 4599 546 1527 3537 789 2723 573 4529 4522 
1 3 1007 2484 4599 
1 6 2367 1110 478 4546 1465 4513 
2 8 325 4444 2189 1771 4420 1038 4390 2853 
1 6 2011 472 3239 678 516 1674 
1 4 4496 4481 2184 1035 
1 3 5048 2540 578 
2 13 5082 1917 1471 1545 1200 2478 737 5235 5253 2551 5276 2970 5286 
1 30 5276 1977 5294 781 5322 5315 5337 1870 3652 2982 1843 2149 1214 5334 131 3171 5279 1097 1351 1284 3552 5243 1941 3208 392 2689 2937 117 5300 2035 
1 9 1200 5156 1630 5150 1009 2262 5184 5164 5163 
1 4 5082 5064 1001 3292 
2 8 5064 1041 3403 5086 2301 1944 1653 2893 
1 15 2893 2276 1548 1745 2550 5067 984 5113 983 5131 5158 2616 1960 5219 1941 
2 10 5115 610 648 2200 636 1666 5040 5032 771 5010 
1 12 5197 5198 3222 483 3664 2372 5206 340 416 3329 981 5115 
1 12 3482 5312 690 3068 199 1108 1979 5221 3401 2124 5185 2370 
1 15 2440 5204 1989 146 1729 5101 650 476 5042 1116 2259 3346 2606 589 4996 
1 5 5036 2139 693 1374 3480 
1 4 2606 134 2871 4973 
2 7 2440 3336 87 1020 1233 824 385 
1 7 4996 5007 5024 1784 2323 5074 3248 
1 3 4514 166 2986 
1 3 549 966 2414 
1 12 1960 3028 1480 5187 1776 5127 5110 2501 5095 2690 507 5131 
1 12 5018 1127 3492 499 4983 4975 4966 2858 4958 850 2123 2371 
3 9 1476 4276 946 869 334 812 4146 276 4124 
1 4 276 3307 218 2417 
2 10 812 191 2340 3274 4155 2103 2395 3370 4172 767 
1 17 767 2218 2001 904 4161 2820 2559 4122 3358 2348 1702 4066 2092 3350 3369 3987 3977 
1 6 3936 91 2745 2722 3993 3977 
1 6 3987 1558 1002 1027 3943 3928 
1 11 2340 617 3039 4085 1423 4051 2274 2098 3233 4002 3578 
1 6 767 344 1396 4089 1217 2274 
1 20 725 3487 920 4216 795 579 3161 1358 4081 1502 3677 1422 2456 3953 309 430 3909 3608 97 3001 
1 15 1422 1969 3925 2198 3888 1099 3615 868 1095 3220 2128 1159 1581 3802 1728 
1 13 1728 2333 2434 3788 2646 1026 3805 3275 2133 2475 2620 2282 3001 
1 5 3909 1120 1021 3900 3615 
1 13 734 3100 3466 3768 14 821 2457 2879 3753 605 3759 1578 3762 
1 3 1502 1654 584 
1 15 3928 775 219 2928 2498 2608 3867 3881 256 3411 3919 858 1459 2261 3578 
1 10 5317 2101 2662 870 3320 79 5230 238 5212 5197 
1 29 2200 2931 519 5165 1467 3517 1918 969 314 5282 50 1582 3527 2950 2314 2775 5350 1680 5363 1808 1959 1743 3245 886 1570 1255 278 2942 5317 
1 18 824 5313 5325 3303 5324 662 5302 2731 3334 5275 901 5241 1946 2350 331 5144 1236 3248 
1 7 933 1598 320 4939 2474 1873 1945 
1 4 320 3593 313 1101 
1 8 1398 2574 1320 5090 58 3516 1752 3246 
1 5 1320 123 1603 1794 1801 
1 9 2053 1190 3374 3670 5028 1712 2002 2389 3022 
1 5 3374 3141 1877 99 1461 
1 5 5244 1399 3658 327 2841 
1 3 5244 2738 3216 
2 16 1399 2919 1638 2719 2459 5222 5199 5177 1212 2852 5125 891 853 855 1711 5077 
1 5 3216 960 3162 1302 1657 
1 8 5177 1588 5180 5170 1409 1746 5205 3216 
1 2 5125 3500 
2 7 5009 2905 1161 247 2299 627 560 
1 8 5009 1064 485 2376 701 3489 4949 2087 
1 4 627 442 5001 485 
1 4 2354 2324 2856 1256 
1 5 2354 2304 4866 2967 2622 
1 3 2354 1587 1678 
2 6 4789 2597 1034 1331 3021 3427 
1 3 4789 3627 4829 
1 6 4789 528 3129 1364 4842 4860 
2 6 4766 4755 1073 2685 1206 4707 
1 8 4707 204 809 2003 4704 2771 1195 2630 
1 2 2685 1552 
1 5 3144 4786 697 4795 1280 
2 10 3144 4788 1158 692 2164 4834 1328 4798 2454 583 
1 4 4795 4808 2235 4858 
1 8 820 1193 2244 586 4894 2055 4857 2584 
1 4 2255 682 2999 1118 
1 6 2837 4901 429 3669 4909 2579 
1 4 1154 4942 227 820 
1 5 820 3388 3119 4962 1855 
1 3 5036 1848 1394 
1 6 3480 5116 815 2037 2883 111 
1 3 2370 2599 5128 
1 4 1855 913 4977 4968 
1 5 1855 695 5011 944 943 
1 5 2883 5189 5175 666 2034 
1 5 690 5287 1074 1133 3308 
1 3 2044 3409 2232 
1 5 501 4576 667 3632 827 
1 3 548 3087 1658 
